#1,1
AAAAAAAAAAAA
BBBBBBBBBBBA
AAAAAAAAAABA
AAAAAAAAAABA
AAAAAAAAAABA
AAAAAAAAAABA
AAAAAAAABBBA
AAAAAAAABABB
AAAAAAAABABA
!chest,2,1,chleb,chleb,chleb
$rat,4,1